C 30,120,180
F 120,40,80
NO test_files/img/apple.xpm
EA test_files/img/work.xpm
SO test_files/img/valid.xpm
WE test_files/img/water.xpm

11111111111
10010000001
10010001111        111111111
10000N00111        100111101
101101000111111111110011000111111
100100010000000000000000010000001
111111111111111111111111111111111