C 30,120,180
F 120,40,80
NO test_files/img/n2.xpm
EA test_files/img/e2.xpm
SO test_files/img/s2.xpm
WE test_files/img/w2.xpm

11111111111111                11111111111
1W000000010001                11110011001
10111111110101111111111111111111001000101
10000000000100000000000000000000010001001
10101011110011111111110111111100000100011
10111111111001       101     111110111111    111
101       1101  111  101111111111101      111101
10111111111101  1001 100000000000001 1 11  110011
10000000000001   11  111111111111111    11111111
11111111111111