C 189,23,145
F 25,120,120
NO test_files/img/libre.xpm
EA test_files/img/work.xpm
SO test_files/img/yo.xpm
WE test_files/img/water.xpm

11111111111
10010000001
10010001111        111111111
10000N00111        100111101
101101000111111111110011000111111
100100010000000000000000010000001
111111111111111111111111111111111