C 30,120,180
F 120,40,80
NO test_files/img/n2.xpm
EA test_files/img/e2.xpm
SO test_files/img/s2.xpm
WE test_files/img/w2.xpm


111111111
111001111
1000000N1
111111111
111111111
111111111
