C 1,1,1
F 2,2,2
NO test_files/valid.xpm
EA test_files/valid.xpm
SO test_files/valid.xpm
WE test_files/valid.xpm

111111111
100000001
100000001111111111
1000E0000000000001
1000E0001111111111
100111111
111
