C 189,23,145
F 25,120,120
NO test_files/img/libre.xpm
EA test_files/img/work.xpm
SO test_files/img/yo.xpm
WE test_files/img/water.xpm


1111111
1111N11
1111111