C 1,2,3
F 213,211,21
EA files/.xpm
NO files/.xpm
SO files/.xpm
WE files/.xpm

111111111111111   1
1001  101 1N101  101
111111111 11 11   1
