C 189,23,145
F 25,120,120
EA test_files/img/e2.xpm
NO test_files/img/n2.xpm
SO test_files/img/s2.xpm
WE test_files/img/w2.xpm

1111
1N01
10011111111
10000000001
11111111111