111111
100001
101001
10N01
111111
